1111111111111111111111111111111111
1P100C00011110000C00000C0111111111
10100101010C000010100111110000C0C1
1010110000000010001001000000011111
1C110100C000000111111000010000C011
1000000010000000000000000000000001
1111111110111111111111111111111111
1E000000000000000000000000000000C1
1111111111111111111111111111111111