1111111111111111111111111111111111
1C000C00001110000C00000C0000000101
10000101001C100010100100000001C1C1
100E110010P00010001001000000010001
1C000100C000000000000000000000C011
1111111111111111111111111111111111