1111111111111111111111111111111111
1E000000000000C00000C0000000000011
1110010100100000101001000000010101
1010010010101010001001000000010101
1P0000000C01C000000000000000000C11
1111111111111111111111111111111111