1111111111111111111111111111111111
1P000C00001110000C00000C0000000101
10000101000C000010100100000000C0C1
1000110010100010001001000000010001
1C000100C000000000000000010000C011
1000000010000000010000000000000001
1111111111111111111011111110111111
1E000000000000000000000000000000C1
1111111111111111111111111111111111