111111111111111111111111111111111111111
1P100C00011110000C00000C011111111000001
10100101010C000010100111110000C00000001
101011000000001000100100000001111000001
1C110100C000000111111000010000C01000001
100000001000000000000000000000000000001
111111111011111111111111111111111000001
1E000000000000000000000000000000C000001
100000000000000000000000000000000000001
100000000000000000000000000000000000001
1000000000000000000000000000000C0000001
10000000000000C000000000000000000000001
1000000000000000000000000000000C0000001
1000000000000000000000000000000C0000001
10000000000C000000000000000000000000001
1000000000C0000000000000000000000000001
111111111111111111111111111111111111111
