111111111
100000001
10P000001
1001E1001
111111111