111111111
100C0C001
1000E0001
10P000011
111111111