111111111
100C0C001
10P0100C1
1001E1001
111111111