111111111
10000C001
10P000000
1001E1001
111111111