111111111
100C0C001
1000E0001
10P0000C1
111111111