111111111
10000C001
10P000001
100110E11
111111111